22222222222222222222222222222222
20000000000000000000000000000002
20000000000000000000000000000002
20000000000000000000000000000002
20000000000000000000000000000002
20000000000000000000000000000002
20000000000000000000000000000002
20022222200000000000000222222002
20000000000000000000000000000002
20000000000000000000000000000002
20000000000022222222000000000002
20000000000000000000000000000002
20000000000000000000000000000002
20022222200000000000000222222002
20000000000000000000000000000002
20000000000000000000000000000002
20000000000022222222000000000002
22222222222222222222222222222222